Width=20;Height=10;
Layout=
0 0 0 0 1 1 1 1 1 0 0 1 1 1 1 1 1 1 1 1
0 0 0 0 0 1 1 1 1 0 0 1 1 1 1 1 1 1 1 1
0 0 0 0 0 0 1 1 1 0 0 1 1 1 1 1 1 1 1 1
0 0 0 0 0 0 0 1 1 0 0 1 1 1 1 1 1 1 1 1
0 0 0 0 0 0 0 0 1 0 0 1 1 1 1 1 1 1 1 1
0 0 0 0 0 0 0 0 0 0 0 1 1 1 1 1 1 1 1 1
0 0 0 0 0 0 0 0 0 0 0 1 1 1 1 1 1 1 1 1
1 1 1 1 1 1 1 1 1 1 1 1 1 1 1 1 1 1 1 1
1 1 1 1 1 1 1 1 1 1 1 1 1 1 1 1 1 1 1 1
1 1 1 1 1 1 1 1 1 1 1 1 1 1 1 1 1 1 1 1;